NO ./texture/mur1_256.xpm



SO ./texture/mur2_256.xpm

              	 	 	 WE ./texture/mur3_256.xpm
EA ./texture/mur6_256.xpm



F 150,200,100


C 200,150,100




11111111111111111111111111111111111111111111111111111111111111111111111
100000000000000000000000000000000000000000000000000000000000000000CZD01
1000000000000000000000000000000000000000100000000000010000000000000001
10000000110000000000001000000000100000100000010001000000000000000000001
10000000000100000001000000000000000000000000000010100000000001000000001
10000010000000011000000000011000000010000100010000000000000000000000001
10000000000000000001000000000000000000010000000000000000100000100000001
10000010001000000000000100000000010000000000100000000000000000100000001
10Z00000000001000000000010000000000000000000000001010000010000001000101
10000000100000010000000000000100000000001000000000100000000000000000001
100000001100000000000001000000000001100000100000100101100100Z0000100101
10000000000010C00000000000000C00000000000000000000000000100000000000001
10000001010000000000000000000000000000000000010000000000000000000000001
10000001001100000000000110000000100111111110000010000100000100010000001
10000000001001000100000000000100000000000000000000000001001001010000001
10000000010000010000000000000000000000000000000000001000000000000010001
10001000000000000000000000000000000000000000000000000000000010100000001
10000010000000000001000000011111100000000100000000000010001000000000001
1000000000000100000000001001N100000000Z00000010000000000001111111111111
100000001000000001000000000001010100000000000100010010100001111
10000000001000011000001000000100000100001000000000000000110000011111111
10000000101000000100000000000000000000000000000000000000001000001000101
10001000011000001000000000000000010000000100000000000000101000000000001
10000100010000101000010100100000000000000000000000010000000000000100001
1000110000000000000100000000100000000100000000001000001D000000000100001
10000000101000011000000101000100000000000101000000000001000000000000001
10010100000000000000010000000000001000010000000100000000000010000100001
10000000000001010001011010011000010011000000010000000010010000000000001
100000101000000000100001000000010000C0000000000000001000000000000000001
10000000000010010000000000111000010000010010000000000100000000110000001
10000010000010100100000100100000100001000101101001001001001001010000001
10000100000000000000000000100000000100000010000000000100000100010000001
11111111111111111111111111111111111111111111111111111111111111111111111