NO ./texture/mur1_256.xpm



SO ./texture/mur2_256.xpm
WE ./texture/mur3_256.xpm


EA ./texture/mur6_256.xpm



F 135,206,235


C 20,30,40



111111
10D0N1
111111