NO ./texture/mur1_256.xpm



SO ./texture/mur2_256.xpm


WE ./texture/mur3_256.xpm
EA ./texture/mur6_256.xpm



F 135,206,235


C 20,30,40




111111111111111111111111
10C000C0000C000Z0Z0Z0001
1001111D1111C00000001001
100000000000000000111001
1000000000000000000C1001
1000000000000000000Z1001
1000000N0000000000Z00001
100000000000000000C00001
10000100000Z000000100001
100011100000000000110001
100111110000000000111001
1000000000000ZCZ00000001
111111111111111111111111
