NO ./texture/mur.xpm



SO ./texture/mur2.xpm


WE ./texture/mur3.xpm
EA ./texture/mur4.xpm



F 150,200,100


C 200,150,100




1111111111111111111111111111
1000000000000000000000000001         11111111111
1000000000000000000000000001         10000000001
1000000000000000000000000001         10000000001
1000000000000000000000000001         10000000001
1000000011111111111111111111         10000000001
100000001                            10000000001
100000001                            10000000001
100000001                            10000000001
100000001                            10000000001
100000001                            10000000001
10000000111111111111111111111111111111000000000111111111111111111111111
10000000000000000000000000000000000000000000000000000000000000000000001
10000000000000000000000000000000000000000000000000000000000000000000001
10000000000000000000000000000000000000000000000000000000000000000000001
10000000000000000000000000000000000000000000000000000000000000000000001
11111111111111111111100000000011111111111111111111111111111111111111111
                    10000000001
                    10000000001
                    10000000001
                    10001100001
                    10000000001
                    10000000001
                    10000000001
                    10000001111
          1111111111100000000011111111111111111
          1000000000000000000000000000000000001
          1000000000000000000000000000000000001
          1000000000000000000000000000000000001
          1000000001000000000000000000000000001
          1000000001000000000000000000000000001
          1000000001000000000000000000100000001
          100000000100000000N000000000100000001
          1000000001000000000000000011111000001
          1000000001000000000000000000001000001
          1000000000000000000000000000000000001
          1111111111111111111111111111111111111




