NO ./texture/mur1_256.xpm



SO ./texture/mur2_256.xpm


WE ./texture/mur3_256.xpm
EA ./texture/mur6_256.xpm



F 210,80,50


C 20,30,40




1111111111111111111111111111
100000000000000000D000000001         11111111111
10000000000Z0000000000000001         1ZZZZZZZZZ1
1000000000000000000000000001         10000000001
10000000000000000Z0000000001         1000C000001
1ZZ000ZZ11111111111111111111         10000000001
100000001                            10000000001
100C00001                            1000ZZ00001
100000001                            10000000001
100000001                            10000000001
100000001                            10000000001
1Z00000Z111111111111111111111111111111000000000111111111111111111111111
1000000000000000000000Z0000000000000000000000000000000000000000000000Z1
100C000000000C000000000000000000000000000000000ZZ00000000C00000000000Z1
100000000000000000000000000000000000000000000000000000000000000000000Z1
100000000000000000000000000Z00000000000000000000000000000000000000000Z1
11111111111111111111100000000011111111111111111111111111111111111111111
                    10000000001
                    1000C000001
                    10000000001
                    10001100001
                    10000000001
                    10Z00000001
                    10000000001
                    10000001111
          1111111111100000000011111111111111111
          1000000000000000000000000000000000001
          1000000000000000000000000000000000001
          10000000000000000000Z0000000000000001
          1000000001000000000000000000000000001
          10000C0001000000000000000000000000001
          1000000001000000000000000000100000001
          100000000100000000N000000000100000001
          1000000001000000000000000011111000001
          1000000001000000000000000000001000001
          1000000000000000000000000000000000001
          1111111111111111111111111111111111111




