NO ./texture/mur.xpm



SO ./texture/mur2.xpm


WE ./texture/mur3.xpm
EA ./texture/mur4.xpm



F 150,200,100


C 200,150,100




111111111111111111111111
100000000000000000000001
100111100000000000001001
100000000000000000111001
100000000000000000001001
100000000000000000001001
100000000000N00000000001
100000000000000000000001
100001000000000000100001
100011100000000000110001
100111110000000000111001
100000000000000000000001
111111111111111111111111
